W W W W W W W W PyW W
W > > > > > > > > v W
W ^ . . . Dy. . . PBW
W ^ . p p W W DbDbDbW
W ^ . g . PG. Dg. F W
W W W W W W W W W W W
