W W W W W W W
W . . Pg. . W
W . . g . . W W W W W
W . . . . . W . . . W
W . p . p . Dg. F . W
W . . . . . W . . . W
W W W W W W W W W W W
