W W W W W W W W W F W
W >s>s>s>s>s>s>s. . W
W ^sW W W W DgW W DbW
W ^sPbPGp p . . . . W
W ^sW W W W . . . . W
W ^sW . g   . . p . W
W ^sW . . . . . . . W
W W W W W W W W W W W
