W W W W W W W W W W W
W . . . . W . . . . W
W . . p . W . . . F W
W . g . . Dr. PR. . W
W . . p . W . . . F W
W . . . . W . . . . W
W W W W W W W W W W W
