W W W W W W W W W W W
W PBW . . . . . W F W
W PgW . p m p . W DbW
W ^ W . . . . . W DgW
W ^ . . . g . . . . W
W ^ . . . . . . . . W
W W W W W W W W W W W
