. . . . . . Pb<s. . . . .
W W W W W W PG<sW W W W W
W . vs<s<s<sW p . Dr. . W
W . vs. . ^sW . . Dr. m W
W DbDb. W ^sW DgW W DrDrW
W . . . . p p p . . . . W
W . . . . . g . . . W VsW
W . . . . . . . . . W p W
W W W W W W W W W W W F W
