W W W W W W W W PyW W
W >s>s>s>s>s> > > v W
W ^s. . . Dy. . . PBW
W ^ . g . W W DbDbDbW
W W p p . PG. Dg. F W
W . . . . W . Dg. . W
W W W W W W W W W W W
