W W W W W W W W W
W > > > > > . F W
W ^ W W DbW W W W
W ^ W . . . . . W
W ^ Pb. g p p . W
W ^ W . . . . . W
W W W W W W W W W
