W W W W W W W W W W W
W . . . g . v v < < W
W . . . . W v v Pg^ W
W . p . p W v v ^ ^ W
W . . . . W v > ^ ^ W
W DgW . . W > > > ^ W
W . W W W W W W W W W
W F W 
W W W
