W W W W W W W W W W W
W . . . . . . . . . W
W . . . . . . . . . W
W . . g . . p . F . W
W . . . . . . . . . W
W . . . . . . . . . W
W W W W W W W W W W W
