W W W W W W W W W W W
W . . . . . W . . . W
W . m . m . W W W W W
W . . . . . PG. DgF W
W . g . p . W W W W W
W . . . . . W . . . W
W W W W W W W W W W W
