W W W W W W W W W
W >s>s>s>s>s>svsW
W ^s. . . . . v W
W ^s. . . . . v W W W
W ^s. g . p . v . F W
W ^s. . . . . v W W W
W ^s. . . . . v W
W ^s<s<s<s<s<s<sW
W W W W W W W W W
