W W W W W W W W W W W
W . . . . . . . Pb. W
W . >s>s>s>s>s>sPRPgW
W . ^s. . p . . ^s. W
W . ^sm Dbg p >s^s. W
W . W . . p . W . . W
W W W W W DbW W W W W
. . . . W DgW . . . .
. . . . W DrW . . . .
. . . . W F W . . . .
. . . . W W W . . . .
