W W W W W W W W W
W > > > > > > v W
W ^ . . . . . v W
W ^ . . . . . v W W W
W ^ . g . p . v . F W
W ^ . . . . . v W W W
W ^ . . . . . v W
W ^ < < < < < < W
W W W W W W W W W
