W W W W W W W W W W W W W
W . . . . . . . W . . . W
W . PgPbPrPy. . W . . . W
W . . . . . . . Dg. . . W
W . . g . . . . Db. . F W
W . . . . . . . Dr. . . W
W . . p p p . . Dy. . . W
W . . . . . . . W . . . W
W . . . . . . . W . . . W
W W W W W W W W W W W W W
